NO ./textures/north_texture.xpm
WE ./textures/west_texture.xpm
EA ./textures/east_texture.xpm


F 220,100,0
C 225,30,0  

SO ./textures/south_texture.xpm

                                        11111
                                       100S001
        1111111111111111111111          10001           11111111111111111111111111
    1111000000000000000000000011111111111000111111111111000000000000000000000001111111
11110000000000000000000000000000000000000000000000000000000000000000000000000000001111
11110000000000000000000000000000000000000000000000000000000000000000000000000000001111
11110000000000000000000000000000000000000000000000000000000000000000000000000000001111
    111100000000000000000000001111111111000001111111111100000000000000000000001111
        1111111111111111111111          10001           1111111111111111111111
                10001                   10001                   10001
                10001                   10001                   10001
                10001                   10001                   10001
             11110001111                10001                11110001111
            1000000000001               10001               1000000000001
            1000000000001               10001               1000000000001
             11110001111                10001                11110001111
                10001                   10001                   10001
                10001                   10001                   10001
                10001                   10001                   10001
                10000111111111111111111110001111111111111111111110001111111111111111111111111111111111111111111111111111111111111111111111111111111111111111
                10000000000000000000001110000000000000000000000000000000000000000000000000000000000000000000000000000000000000000000000000000000000000000001
                10000000000000000000000000000000000000000000000000000000000000000000000000000000000000000000000000000000000000000000000000000000000000000001
                10000000000000000000000000000000000000000000000000000000000000000000000000000000000000000000000000000000000000000000000000000000000000000001
                10000000000000000000001110000000000000000000000000000000000000000000000000000000000000000000000000000000000000000000000000000000000000000001
                11111111111111111111111111111111111111111111111111111111111111111111111111111111111111111111111111111111111111111111111111111111111111111111
